NO ./path_to_the_north_texture
SO ./path_to_the_south_texture
WE ./path_to_the_west_texture
EA ./path_to_the_east_texture

F 220,100,0
C 225,30,0

111111111111111111111111111111
100000000011000000000000000001
101100000111000000000000000001
100100000000000000000000000001
111111111011000001110000000001
100000000011000001110111111111
111101111111110111000000010001
111101111111110111010010010001
110000001101010111000000010001
100000000000000011000000010001
100000000000000011010010010001
1100000111010100111111110N0111
11110111 1110101 1001111010001
11111111 1111111 1111111111111